Любовь — вновь — кровь
Глаз — алмаз — нас — сейчас — раз
Нет — ответ — свет — привет — лет — след — бед — побед — бред — портрет — поэт    
Розы — морозы — мимозы — грезы — слезы
Тебе — судьбе — борьбе
Доля — воля — поля
Дело — тело — смело
Чувство — искусство
Ты — красоты — цветы — мечты — черты — пустоты
Тебя — любя
Один — господин
Два — голова — дрова — трава — молва — слова
Три — посмотри
Четыре — в квартире — мире
Пять — опять — печать
Шесть — есть — есть — честь — месть
Восемь — просим
Да — еда — вода — всегда — года — борода — поезда — беда — города
Она — окна — луна — вина — вина
Дом — нем
Отец — конец — венец — сердец
Мы — зимы — умы — тьмы
Зима — сама
Мне — вдвойне — войне — стране — сне — весне — тишине
Небеса — чудеса — краса — леса — полоса
Речь — сечь — меч
Стих — стих — своих
Природа — погода
День — тень — пень — сирень — набекрень — лень — олень — плетень
Смех — грех — всех — успех
Друг — вдруг — вокруг — юг
Море — горе — на просторе
Жизни — отчизне
Путь — суть — грудь
Ночь — дочь — прочь — помочь
Слова — снова
Грусть — пусть
Жаль — даль — печаль
Идти — пути
Он — сон — миллион
Любви — живи
Меня — дня — огня — коня
Руки — скуки — разлуки
Бремя — время
Награда — надо — взгляда — рядом — снегопада
Ум — дум
Дверь — зверь — потерь — теперь
Апрель — капель — акварель — постель — метель
Снег — нег — человек — бег
Милый — силы — могилы
Души — тиши — хороши
Солнце — донце — оконце
Осень — просим — просинь — проседь
Клены — зеленый
Несчастный — ненастный — ужасный — опасный
Ночи — очи
Год — идет
Дети — на свете
Король — ноль — пароль
Интересно — чудесно — известно — песня
Боги — дороги — ноги — тревоги
Ладонь — огонь — тронь
Вечер — ветер
Вечер — свечи
Боли — боле — роли
Дожди — подожди — впереди — позади
Краски — маски
Вы — увы